11111111
1P0100E1
101C1001
11111111
