11111111
10P100E1
101C1001
11111111
