11111111
10P001E1
101C1011
11111111
