11111111
1P0000E1
10C00001
111111111111111
