11111111111
1P0000E0001
10C000001
11111111111
