11111111
100C0001
1P010CE1
11111111
